R  500 500

NO ./texture/redbrick.xpm
SO ./texture/doom.xpm
WE ./texture/wall.xpm
EA ./texture/eagle.xpm

S ./texture/skeleton.xpm
F 255,255,0
C 255,255,0

11111111111111
10111111111111
