NO ./texture/wall.xpm
SO ./texture/doom.xpm
WE ./texture/redbrick.xpm
EA ./texture/eagle.xpm

F 40,50,20
C 40,160,255

1111111111111
1111000000001
100000E000001
100000111111
100001      01
1000000000001
1111111011111
