NO		./texture/wall.xpm
SO	./texture/doom.xpm
WE ./texture/red brick.xpm
EA ./texture/eagle.xpm

F			224,  	 172, 	105 		
C 255		 ,255,	 0 	 	

111111111111111111111111111111111111111111111111111111111
100000000000000000001010000000100000000000000000000000001
100010100000000000101010000000100000000000000000100000001
1000100000000000000000000000001000000000N0000000100000001
100010100000000000101010000000000000000000000000100000001
100000000000000000001010000000000010101000101010100000001
101010100010101010101010101000101010000000000000100000001
101010100010101010101010101000101010001000100000000000001
101000000000000010100010001000101000000000000000000000001
100000000000000000000000000000000000000000000000000000001
100000000000000000000000000000000000000000000000000000001
101000000000000010100010001000101010101000101010100000001
101010100010101010101010001000101010101000101010100000001
111111111111111111111111111111111111111111111111111111111
