NO ./texture/redbrick.xpm
SO ./texture/doom.xpm
WE ./texture/wall.xpm

F 255,255,0
C 255,255,0

11111111111111
100000000N00001
11111111111111
