R 500 5000

NO ./texture/wall.xpm
SO ./texture/doom.xpm
WE ./texture/redbrick.xpm
EA ./texture/eagle.xpm

S ./texture/skeleton.xpm
F 40,50,20
C 40,160,255

1111101111111
1111000000001
1002000000001
100200N000001
100200      01
1002000000001
1111111111111
