
NO ./texture/redbrick.xpm      	
SO ./texture/doom.xpm
WE ./texture/wall.xpm
EA ./texture/eagle.xpm
F 
F 255,0,111 
C  0, 0, 255

 1111
1N0001
111111
