NO ./texture/wall.xpm
SO ./texture/doom.xpm
WE ./texture/redbrick.xpm
EA ./texture/eagle.xpm

F 40,50,20
C 40,160,255

1111101111111
1111000000001
1000000000001
100000N000001
10000011111101
1000001      01
100000111111001
10000000000001
1111111111111
