NO ./texture/wall.xpm
SO ./texture/doom.xpm
WE ./texture/redbrick.xpm
EA ./texture/eagle.xpm

F 40,50,20
C 40,160,255

1111101111111
1111000000001
1000000000001
100000N000001
100000      01
1000000000001
1111111111111
