NO ./texture/redbrick.xpm
SO ./texture/doom.xpm
WE ./texture/wall.xpm
EA ./texture/eagle.xpm

F 255,255,0
C 255,255,0

11111111111111
1000E0000N00001
11111111111111
