NO ./texture/redbrick.xpm
SO ./texture/doom.xpm
WE ./texture/wall.xpm
EA ./texture/eagle.xpm

F 255,255,0
C 255,255,0

11111111111111
10000000000001
10000000000001
10002E00000021
10111111111111
