R  1000 500

NO ./texture/wall.xpm
SO ./texture/doom.xpm
WE ./texture/redbrick.xpm
EA ./texture/eagle.xpm

S ./texture/skeleton.xpm
F 224,172,105
C 205,249,255

111111111111111111111111111111111111111111111111111111111
100000000000000000001010000000200000000000000000000000001
100010100000000000101010000000200000000000000000100000001
1000102000000000000000000000002000000000N0000000100000001
100010100000000000101010000000200000000000000000100000001
100000000000000000001010000000200010101000101010100000001
101010100010101010101010101000101010000000000000100000001
101010100010101010101010101000101010001000100000000000001
101000000000000010100010001000101000000000000000000000001
100000000000000000000000000000000000000000000000000000001
100000000000000000000000000000000000000000000000000000001
101000000000000010100010001000101010101000101010100000001
101010100010101010101010001000101010101000101010100000001
111111111111111111111111111111111111111111111111111111111
