R  720 720

NO ./texture/wall.xpm
SO ./texture/doom.xpm
WE ./texture/redbrick.xpm
EA ./texture/eagle.xpm


S ./texture/skeleton.xpm
F 224,172,105
C 205,249,255

111111111111111111111111111111111
101010101010101010101010101011111
100000000000000000000000000001111
100000000000000000000000000000111
100000000000000000000000000000011
100000000000000000000000000000001
100000000000100000100000000000001
100000000000000000000000000000001
100000000000000000000000000000001
100000000000000000000000000000001
100000000000000000001000000000001
100000000000000000000000000000001
100000000000000000111111111111111
1000000000000000N01
1111111111111111111
