NO ./texture/wall.xpm
SO ./texture/doom.xpm
EA ./texture/eagle.xpm
WE ./texture/redbrick.xpm


F 40,50,20

C 40,160,255



 111
10001                  1     1
10001                 1S1   101
 100111              10001 10001
  1000011111111111111000001000001
   1100000000000000000000000000001
    1000000000000000000000000000001
    10000000000000000000000000000001
    10111111111101111111111111111111
    101        101
    101        101
    101        101
    10111111111101
    10000000000001
    11111101111111
         101
          1
             
             
       111111
       111
        11
